apple : 사과
banana : 바나나
cat : 고양이
dog : 개
elephant : 코끼리
fish : 물고기
grape : 포도
house : 집
ice : 얼음
jungle : 정글
kite : 연
lion : 사자
monkey : 원숭이
notebook : 공책
orange : 오렌지
penguin : 펭귄
queen : 여왕
rabbit : 토끼
sun : 태양
tiger : 호랑이
umbrella : 우산
violin : 바이올린
water : 물
xylophone : 실로폰
yacht : 요트
zebra : 얼룩말
computer : 컴퓨터
keyboard : 키보드
mouse : 마우스
phone : 전화기
fuck you : 꺼져
konkuk : 건국대
